911111111111111111111111111113
800000000000000000000000000002
800000000000000000000000000002
800000000000000000000000000002
800000444440000000444440000002
800046FFFFFC400046FFFFFC400002
8006FFF97BFFFC06FFFBD3FFFC0002
802FFBD2BAD3FFAFFD3A907BFF8002
806FBC5286BABFEF95446856BFC002
82FFC392C52AAFFF87B93A93AFF802
82FBB82EBBC443F94546E82EABF802
82F842C7C451787817B97EE902F802
82FE901539141296ED06BBD6AEF802
82FFAEAD42EFE82FFF8784556FF802
803FEBED56BFD6A97FABC3957F9002
802FFC553BAFFF86FFA87807FF8002
8003FFD50047BFAFD506BAEFF90002
80003FFD6C3D2FAFFF8786FF900002
800003FFD1452D2915416FF9000002
8000003FFED141428796FF90000002
80000003FFD6943AC7EFF900000002
800000003FFD43AC57FF9000000002
8000000003FFD6817FF90000000002
80000000003FFD2EFF900000000002
800000000003FFEFF9000000000002
8000000000003FFF90000000000002
80000000000003F900000000000002
80000000000002F800000000000002
800000000000001000000000000002
C44444444444444444444444444446

15,15
17,17