91155555555555555557
AA815555555555555557
AAA85551555551155557
AAA857F813FFFA811117
AAA817FEE857FAAAAA87
AAAA87FFFAFFFAAAAA87
AAAA8557FAFD52AAAA87
AAAA8117FEFFFEEEEEC7
AAAAAA85555555555557
EEEEEEC5555555555557

0,0
10,9