955555555555555555555555555557
855555555555555555555555555557
811555555555555555555555555557
AA8555555555555555555555555557
AA8115555555555555555555555557
AAAA85555555555555555555555557
AAAA85555555555555555555555557
AAAA85555555555555555555555557
AAAA81555555555555555555555557
AAAAA8555555555555555555555557
AAAAA8555555555555555555555557
AAAAA8111111555555555555555557
AAAAAAAAAAAC155555115555555557
AAAAAAAAAAAF813FFFA85555555557
AAAAAAAAAAAFEE857FA81155555557
AAAAAAAAAAAFFFAFFFAAA855555557
AAAAAAAAAA813FAFD52AA855555557
AAAAAAAAAAAAAFAFFFEEEC55555557
AAAAAAAAAAAA878555555555555557
AAAAAAAAAAAA878155555555555557
AAAAAAAAAAAA83A815555555555557
AAAAAAAAAAAAAAAA81111555555557
AAAAAAAAAAAAAAAAAAAA8555555557
AAAAAAAAAAAAAAAAAAAA8115555557
AAAAAAAAAAAAAAAAAAAAAA85555557
AAAAAAAAAAAAAAAAAAAAAA81111157
AAAAAAAAAAAAAAAAAAAAAAAAAAA857
AAAAAAAAAAAAAAAAAAAAAAAAAAA857
AAAAAAAAAAAAAAAAAAAAAAAAAAA813
EEEEEEEEEEEEEEEEEEEEEEEEEEEEEE

0,0
29,29