911111111111111117F91111111113
80000000000000006FF80000000002
8000000000000006FBFC0000000002
800000000000002F903F8000000002
804440000000006FEAAF8000000002
82FFFC44440006FB96EF8000000002
803FBFFFFFC46FD42BBF8000000002
802FC3BBBBFFF97946AFC000000002
8003FC442A957C3857ABF800000002
8002FD53AC0797AC3B86FC00000002
80003F90410147854043FFC4000002
80002FEAD6AABD2BD03853FFC40002
800003FAD52C0106D6E8787BFFC402
800002FED16FAAEFFF907C7857FFC2
8000007FD07FEC157FEC3954557FFA
800002FD503FFFAFFF9100557FF912
800006FD3AABBFAFD56EAC7FF91002
80002FD142E86FAFFF916FF9100002
80006FD03C3857C3BBEEF910000002
8002FD52878013940017F800000002
8006F91287EEEAC3AA87F800000002
802F96EEC7FFFC7EAEEF9000000002
806FEFFFFF913FD1013F8000000002
82FFF911110003FEAAAF8000000002
801110000000003FEAEF8000000002
800000000000002FD07F8000000002
8000000000000003FEF90000000002
80000000000000003FF80000000002
800000000000000003F80000000002
C44444444444444444544444444446

10,10
17,25