91111111111111111113
80000000000000000002
80044444000444440002
806FFFFFC06FFFFFC002
86FFD3BFFEFFB97FFC02
AFFD5443FFFBA857FF82
AFD555507FB844557F82
AFD55150114451157F82
AFD512FAAAFFFA817F82
AFFD2AFEE857FAAEFF82
83FFEAFFFAFFFAEFF902
803FFC13FAFD56FF9002
8003FFEEFAFFFFF90002
80003FFD1017FF900002
800003FFEAEFF9000002
8000003FFEFF90000002
80000003FFF900000002
800000003F9000000002
800000002F8000000002
C4444444454444444446

7,7
12,11
EEEEEESSSSW