911111111117F9111113
80000000006FF8000002
8444400006FBF8000002
AFFFFC446FBAFC000002
83FBBFFFFBAABF800002
82FC291510686F800002
803FC6C3EEB87FC40002
802FD150154453FFC402
8003FAFAC7FFFA97FFC2
8006FAFC5157F80157FA
802F92FFFAFFFAEEFF92
806FAC17FAFD56FF9102
82F907C3FAFFFF910002
86FEAD56D0517F800002
AFD56FFFFC387F800002
AFFFF9113FE87F800002
8111100003FEF9000002
80000000003FF8000002
800000000003F8000002
C4444444444454444446

7,7
9,9