91111111111111111113
80000000000000000002
80044444000444440002
806FFFFFC06FFFFFC002
86FFBBBFFEFF957FFC02
AFFD442BFFFB8557FF82
AFD555407FBA85557F82
AF911150554441157F82
AFEAAAF857FFFA857F82
AFFEAAFC5157FA87FF82
83FFEAFFFAFFFAEFF902
803FFC13FAFD56FF9002
8003FFEEFAFFFFF90002
80003FFD5057FF900002
800003FFD07FF9000002
8000003FFEFF90000002
80000003FFF900000002
800000003F9000000002
800000002F8000000002
C4444444454444444446

7,7
12,11
EEEEEESSSSW
