95555555555555555557
81115555555555555557
AAA85551555551155557
AAA813F813FFFA815557
AAAAAAFEE857FAA85557
AAAAAAFFFAFFFAA85557
AAAAA857FAFD52A81557
AAAAA857FEFFFEEEC557
AAAAA811155555555557
EEEEEEEEC55555555557

0,0
10,9