91111111111111111111111111111111113
80000000000000000000000000000000002
80000000000000000000000000000000002
80000000000000000000000000000000002
80000000000000000000000000000000002
80000000000000000000000000000000002
80000004444444400000444444440000002
8000046FFFFFFFFC0006FFFFFFFFC400002
80006FFFBBB957FFC06FFBBBBBBFFFC0002
8002FF954444557FFAFFBAAAAAABBFF8002
8006F90555555557FEFBAA84444447FC002
802FFA8555555557FFFAAA85555557FF802
802F9285555555557F9444455555557F802
802FAA85555555557F8555555555557F802
802FAA8115555515554515555555557F802
802FEAAA85557F857FFF81155555557F802
802FFAAA81557FC5157FAA85555557FF802
8003FEAAA8557FFFAFFFAA85555557F9002
8002FFEAA815557FAFD52A8155557FF8002
80003FFEAA81557FEFFFEEEC5557FF90002
800003FFAAA8155555555555557FF900002
8000003FEEAA855555555555557F9000002
80000003FFEA8555555555557FF90000002
800000003FFE855555555557FF900000002
8000000003FFC1555555557FF9000000002
80000000003FFC11115557FF90000000002
800000000003FFEAA8557FF900000000002
8000000000003FFEA857FF9000000000002
80000000000003FFE87FF90000000000002
800000000000003FFEFF900000000000002
8000000000000003FFF9000000000000002
80000000000000003F90000000000000002
80000000000000002F80000000000000002
80000000000000000100000000000000002
C4444444444444444444444444444444446

6,10
29,16
SSSSEEEEEEEEEEEEEESEESEEEEEEE