91111111111111111111111111111111113
80000000000000000000000000000000002
80000000000000000000000000000000002
80000000000000000000000000000000002
80000000000000000000000000000000002
80000000000000000000000000000000002
80000004444444400000444444440000002
8000046FFFFFFFFC0006FFFFFFFFC400002
80006FFFD1397BFFC06FFD11557FFFC0002
8002FFBBBAE8787FFAFFBBAC17D17FF8002
8006F90440141297FEFBA86BED16BBFC002
802FFAA97AAD6C03FFFA8078796946FF802
802FD6807AC57D2C3FBAE878385457BF802
802F91687C15392D2F845416869157AF802
802FAAD41787EEC385453943816C796F802
802FE813C7857F92EFFFA83EE817907F802
802FFEAC13E97FEC157FAA8792812AFF802
8003FD6928547FFFAFFFEAC3AEEEAEF9002
8002FFD6E855517FAFD5387AC17BEFF8002
80003FFD1055783FAFFFC2907816FF90002
800003FFA817D287C53D16EC3AAFF900002
8000003FEE817A8557A943D3EEEF9000002
80000003FFEC3AC157EEBC507FF90000002
800000003FFD28785557A97EFF900000002
8000000003FFEAD2B957A87FF9000000002
80000000003FFED0681546FF90000000002
800000000003FFD412857FF900000000002
8000000000003FFD2A87FF9000000000002
80000000000003FFEAEFF90000000000002
800000000000003FFEFF900000000000002
8000000000000003FFF9000000000000002
80000000000000003F90000000000000002
80000000000000002F80000000000000002
80000000000000000100000000000000002
C4444444444444444444444444444444446

6,10
29,16
EEEEEEESEESESSEENEEEEENESSESESEENES