911111111117F9111113
80000000006FF8000002
8444400006FBF8000002
AFFFFC446FD2FC000002
83F93FFFF93C3F800002
82FE85553AC3AF800002
803F853B86BAAFC40002
802FE9686BC443FFC402
8003FAFC3AFFFA93FFC2
8006FAFD6857FC6857FA
802F96FFFAFFF956FF92
806FA913FAFD56FF9102
82F946AEFAFFFF910002
86FA97C552953F800002
AFD46FFFFC6BAF800002
AFFFF9113FD06F800002
8111100003FEF9000002
80000000003FF8000002
800000000003F8000002
C4444444444454444446

9,7
11,11
SSSSSSWWWNNWSWNNENNNENWWNEEEESENNESESSEESSENESSWWSWW