911111111117F9111113
80000000006FF8000002
8444400006FBF8000002
AFFFFC446FD2FC000002
83F97FFFF9543F800002
82FC17913A93AF800002
803F83AA86AEAFC40002
802FE86AEBC543FFC402
8003FAFC56FFFC3BFFC2
8006FAFD5157FBA857FA
802FBAFFFAFFF846FF92
806F86D3FAFD56FF9102
82FBA952FAFFFF910002
86FA86D45453BF800002
AFD46FFFFD3AAF800002
AFFFF9113FC06F800002
8111100003FEF9000002
80000000003FF8000002
800000000003F8000002
C4444444444454444446

9,7
11,11
SWWNNNESENNEEESSSESESSWSWW