911111111117F9111113
80000000006FF8000002
8444400006FBF8000002
AFFFFC446F96FC000002
83F97FFFFD453F800002
82FC17915553AF800002
803F856A93BAAFC40002
802FC17AAEC443FFC402
8003FAFC6BFFFAD3FFC2
8006FAFD5057FC5057FA
802FBAFFFAFFF956FF92
806FAC53FAFD56FF9102
82F9693AFAFFFF910002
86FA96C452953F800002
AFD46FFFFC696F800002
AFFFF9113FD07F800002
8111100003FEF9000002
80000000003FF8000002
800000000003F8000002
C4444444444454444446

9,7
11,11
NWSSWNNNEEEESSEESSEESWWSWW