911111111111111111111111111113
800000000000000000000000000002
800000000000000000000000000002
800000000000000000000000000002
800000444444400044444440000002
800006FFFFFFFC06FFFFFFFC000002
80006FF95157FFEFFBBD3BFFC00002
8002FFD2BC797FFFD2AD443FF80002
8002F978051057F952AD1503F80002
8002FA9687EC17FC7C0787EEF80002
8002F847ED3F857FFFC10397F80002
8002FC39796FC7957F96E807F80002
8002FFC4143FFFAFFFC13EEFF80002
80003FFD03853FAFD53AC7FF900002
800003FFEA87AFAFFF807FF9000002
8000003FFEAD010157AEFF90000002
80000003FFE92AEC396FF900000002
800000003FFEA87B86FF9000000002
8000000003FFEC12EFF90000000002
80000000003FFD2EFF900000000002
800000000003FFEFF9000000000002
8000000000003FFF90000000000002
80000000000003F900000000000002
80000000000002F800000000000002
C44444444444445444444444444446

5,10
10,15
SESEEEESSS