911111111111111111111111111113
800000000000000000000000000002
800000000000000000000000000002
800000000000000000000000000002
800000444444400044444440000002
800006FFFFFFFC06FFFFFFFC000002
80006FFB9557FFEFFBBB97FFC00002
8002FFB84157BFFFD4442BBFF80002
8002FBA87EBBABFD55156AABF80002
8002FC04554406FD552D16AAF80002
8002FB8117BF857FFF878546F80002
8002FC2AC56FC5157FA94557F80002
8002FFE8513FFFEFFF84397FF80002
80003FFC3A857FBFD50786FF900002
800003FFEE817FAFFF87EFF9000002
8000003FFD2851455507FF90000002
80000003FFE8781117EFF900000002
800000003FFE96AA87FF9000000002
8000000003FFE92AEFF90000000002
80000000003FFEAEFF900000000002
800000000003FFEFF9000000000002
8000000000003FFF90000000000002
80000000000003F900000000000002
80000000000002F800000000000002
C44444444444445444444444444446

5,10
10,15
SENESSEEESSS